#;#;#;#;#
#;tp;k;c;#
#;.;.;.;#
#;f;#;.;#
#;#;.;.;#
#;b;.;tp;#
#;#;#;#;#
