#;#;#;#;#;#;#;#
#;s;o;#;f;.;k;#
#;.;.;.;.;.;.;#
#;.;.;#;.;.;.;#
.;.;.;.;.;.;.;.
.;.;t;t;.;.;.;.
.;.;t;t;b;.;.;.
#;#;#;#;#;#;#;#
---
Pizza, Salad
Box: Томат Огурец
Fridge: Томат
