#;#;#;#;#;#;#;#
#;s;o;#;f;.;k;#
#;.;.;.;.;.;.;#
#;.;.;.;.;.;.;#
.;.;.;.;.;.;.;.
tp;.;tp;.;b;.;.;.
tp;.;tp;.;.;tp;c;.
#;#;#;#;#;#;#;#
