#;#;#;#;#
#;o;f;c;#
#;.;.;.;#
#;.;tp;tp;#
#;#;#;#;#
