#;#;#;#;#;#;#
#;.;.;.;o;k;#
#;c;.;.;.;.;#
#;.;.;.;.;.;#
#;.;.;.;.;.;#
#;.;.;.;.;.;#
#;.;.;.;.;.;#
#;#;.;#;#;#;#
#;.;.;.;.;.;#
#;b;.;b;b;b;#
#;#;#;#;#;#;#
