#;#;#;.;.;.
#;s;f;.;.;.
#;.;.;.;.;.
#;.;.;.;.;.
#;.;#;.;.;.
#;#;#;o;.;.
.;k;#;.;.;.
.;.;.;.;.;.
.;.;.;.;.;.
.;.;.;b;b;.
.;.;.;.;.;.
