#;#;#;#;#
#;o;k;c;#
#;.;.;.;#
#;. ;#;.;#
#;f;.;.;#
#;tp;.;tp;#
#;#;#;#;#