#;#;#;#;#
#;tp;k;c;#
#;.;.;.;#
#;#;.;#;#
#;.;.;.;#
#;b;.;b;#
#;#;#;#;#
