#;#;#;#;#;#;#;#
#;s;o;#;f;.;k;#
#;.;.;.;.;.;.;#
#;.;.;.;.;.;.;#
.;.;.;.;.;.;.;.
tp;.;tp;.;b;.;.;k
tp;.;tp;.;.;tp;c;.
#;#;#;#;#;#;#;#
