#;#;#;#;#;#;#;#
#;s;o;#;f;.;k;#
#;.;.;.;.;.;.;#
#;.;.;#;.;.;.;#
.;.;.;.;.;.;.;.
.;.;tp;t;b;.;.;.
.;.;tp;t;.;.;c;.
#;#;#;#;#;#;#;#
