.;.;.;#;#;#;#;#
.;.;.;#;.;.;.;#
.;.;.;#;.;@;.;#
.;.;.;#;.;.;.;#
.;.;.;#;#;#;#;#
