#;#;#;#;#;#;#;#
#;s;o;#;f;.;k;#
#;.;.;.;.;.;.;#
#;.;.;#;.;.;.;#
.;.;.;.;.;.;.;.
.;.;t;t;b;.;.;.
.;.;t;t;.;.;.;.
#;#;#;#;#;#;#;#
