#;#;#;#;#
#;.;#;c;#
#;f;#;.;#
#;.;#;.;#
#;.;#;.;#
#;.;o;.;#
#;.;.;.;#
#;tp;.;#;#
#;.;.;k;#
#;.;.;.;#
#;b;.;tp;#
#;#;#;#;#
